WOOOOOOOOOOOOOOOOOOW
|OOOOOOOOOOOOOOOOOO|
|OOOOOOOOOOOOOOOOOO|
|OOOOOOOOTOOOOOOOOO|
|OOOOOOOOOOOOOOOOOO|
|OOOOOOOOOOOOOOOOOO|
|OOOOOOOOOOOOOOOOOO|
|OOOOOOOOOOOOOOOOOO|
|OOOOOOOOOOOOOOOOOO|
|OOOOOOOOOOOOOOOOOO|
|OOOOOOOOOOOOOOOOOO|
|OOOOOOOOOOOOOOOOOO|
|OOOOOOOOOOOOOOOOOO|
|OOOOOOOOOOOOOOOOOO|
|OOOOOOOOOOOOOOOOOO|
|OOOOOOOOOOOOOOOOOO|
|OOOOOOOOOOOOOOOOOO|
|OOOOOOOOOOOOOOOOOO|
|HOOOOOOOOOOOOOOOOO|
F------------------|
