WOOOIOOOOOOOOOOOOOOW
|OOOOOOOOOOOOOOOOOO|
|OOOOOOOOOOOOOOOOOO|
|OOOOOOL----OOOOOOO|
|OOOOOOOOOOOOOOOOOO|
|OOBBOOOOOOOOOBBOOO|
|OL----OOOOOOL----O|
|OOOOOOOOOOOOOOOOOO|
|OOOOOOOOOOOOOOOOOO|
|OOOOOOL----OOOOOOO|
|OOOOOOOOOOOOOOOOOO|
|OOOOOOOOOOOOOOOOOO|
|OL----OOOOOOL----O|
|OOOOOOOOOOOOOOOOOO|
|OOOOOM--OOOM--OOOO|
|OOOOOOOOOOOOOOOOOO|
|OOS-OOOOOOOOOOOS-O|
|OOOOOOOOOOOOOOOOOO|
|HOOOOOOOOOOOOOOIOO|
F------------------|
