WOOOOOOOOOOOOOOOOOOW
|OOOOOOOOOOOOOOOOOO|
|M--OOOOOOOOOOOOM--|
|OOOOOOOOOOOOOOOOOO|
|OOOOOOL----OOOOOOO|
|M--OOOOOOOOOOOOM--|
|OOOOOOOOOOOOOOOOOO|
|OOOOOOL----OOOOOOO|
|M--OOOOOOOOOOOOM--|
|OOOOOOOOOOOOOOOOOO|
|OOOOOOL----OOOOOOO|
|M--OOOOOOOOOOOOM--|
|OOOOOOOOIOOOOOOOOO|
|OOOOOOL----OOOOOOO|
|M--OOOOOOOOOOOOM--|
|OOOOOOOOBOOOOOOOOO|
|OOOOOOL----OOOOOOO|
|OOOOOOOOOOOOOOOOOO|
|HOOOOOOOOOOOOOOOOO|
F------------------|