WOOOOOOOOOOOOOOOOOOW
|OOOOOOOOOOOOOOOOOO|
|OOOOOBOOOOOOOOBOOO|
|OOOM--OOOOOOM--OOO|
|OOL----OOOOL----OO|
|OOOM--OOOOOOM--OOO|
|OOOOOOOOBOOOOOOOOO|
|OOOOOOOOS-OOOOOOOO|
|OOOOOOOOOOOOOOOOOO|
|OOOBOOOOOOOOOOOBOO|
|OOS-OOOOOOOOOOS-OO|
|OOOOOOOOOOOOOOOOOO|
|OOOOOOOOOBOOOOOOOO|
|OOOOOOOOS-OOOOOOOO|
|OOOOOOOOOOOOOOOOOO|
|OOOOM--OOOOOOM--OO|
|OOOL----OOOOL----O|
|OOOOM--OOOOOOM--OO|
|HOOOOOOOOOOOOOOOOO|
F------------------|