WOOOOOOOOOOOOOOOOOOW
|OOOOOOOOOOOOOOOOOO|
|OOOOOOOOOOOOOOOOOO|
|OOOOOOOOZOOOOOOOOO|
|OOOOOOOOOOOOOOOOOO|
|OOOOOOOOOOOOOOOOOO|
|OS-OOOOOOOS-OS-OOO|
|OS-OOOOOOOS-OS-OOO|
|OS-OOOOOOOS-OS-OOO|
|OS-OOOOOOOS-OS-OOO|
|OOOOOOOOOOOOOOOOOO|
|OOOOOROOOOOOOOOOOO|
|OS-OS-OOOOS-OOOOOO|
|OS-OS-OOOOS-OOOOOO|
|OS-OS-OOOOS-OOOOOO|
|OS-OS-OOOOS-OL----|
|OOOOOOOOOOOOOOOOOO|
|OOOOOOOOOOOOOOOOOO|
|HOOOOOOOOOOOOOOOOO|
F------------------|
