WOOOOOOOOOOOOOOOOOOW
|OOOOOOOOOOOOOOOOOO|
|OOOOOOOOOOOOOOOOOO|
|OOOOOOOOOOOOOOOOOO|
|OOOOOOOM--OOOOOOOO|
|OOOOOOOOOOOOOOOOOO|
|OBOOOOOOOOOOOOOOBO|
S-OOOM--M--S-S-OOOS-
|OOOOOOOOOOOOOOOOOO|
|OOOOOOOOBOOOOOOOOO|
S-OOOM--M--S-S-OOOS-
|OOOOOOOOOOOOOOOOOO|
|OOOOOOOOOOOOOOOOOO|
S-OOOM--M--S-S-OOOS-
|OOOOOOOOOOOOOOOOOO|
|OOOOOOOOOOOOOOOOOO|
S-OOOM--M--S-S-OOOS-
|OOOOOOOOOOOOOOOOOO|
|HOOOOOOOOOOOOOOOOO|
F------------------|
