WOOOOOOOOOOOOOOOOOOW
|OOOOOOOOOOOOOOOOOO|
|IOOOOOOOOOOOOOOOOI|
|F-----------------|
|OOOOOOOOOOOOOBOOOO|
|OOOOOOOOOOOL----S-|
|OOOOOOOOOOS-OOOOOO|
|OOOOOOOOOS-OOOOOOO|
|OOOOOOOOS-OOOOOOOO|
|OOOOOOOS-OOOOOOOOO|
|OOOOOOS-OOOOOOOOOO|
|OOOOOS-OOOOOOOOOOO|
|OOOOS-OOOOOOOOOOOO|
|OOOS-OOOOOOOOOOOOO|
|OOS-OOOOOOOOOOOOOO|
|OS-OOOOOOOOOOOOOOO|
|S-OOOOOOOOOOOOOOOO|
S-OOOOOOOOOOOOOOOOO|
|HOOOOOOOOOOOOOOOOO|
F------------------|